NO assets/textures/north.xpm
SO assets/textures/south.xpm
WE assets/textures/west.xpm
EA assets/textures/east.xpm
F 100,0,0
C 80,120,170

11111111111111111111111111111111
10000000000000000000000000000001
10000000000000011100000000000001                              
10000000111111100011111110000001
1000000000000000000000N000000001
10000000000000000000000000000001
11111111111111111111111111111111
11111111111111111111111111111111
10000000000000000000000000000001
11111111111111111111111111111111
