SO assets/textures/south.xpm
111111111
100000001
100000001
1000E0001
100000001
100000001
111111111
NO assets/textures/north.xpm
WE assets/textures/west.xpm
EA assets/textures/east.xpm
F 0220,100,0
C 225,30,0
