NO assets/textures/north.xpm
SO assets/textures/south.xpm
WE assets/textures/west.xpm
EA assets/textures/east.xpm
F 0220,100,0
C 225,30,0
111111111
1N0000001
100000001
1000E0001
100000001
100000001
111111111
