NO assets/textures/north.xpm
SO assets/textures/south.xpm
WE assets/textures/west.xpm
EA assets/textures/east.xpm
F 220,100,0
C 225,30,0

111111
10NS01
10EW01
100001
111111
