NO assets/textures/north.xpm
SO assets/textures/south.xpm
WE assets/textures/west.xpm
EA assets/textures/east.xpm

F 220,100,100
C 225,30,100


111111111111111
100000000000001
100000000000001
100000000000001
100000000000001        11111
10000000000E001        10001
100000000000001        10001
100000000000001        10001
100000000000001        11111
100000000000001
100000000000001
100000000000001
100000000000001
100000000000001
111111111111111
