NO assets/textures/north.xpm
SO assets/textures/south.xpm
WE assets/textures/west.xpm
EA assets/textures/east.xpm

F 220,100,100
C 225,30,100

11111111111111111111
10000000000000000001
10000000000000000001
10000011111110000001
10000010000010000001
10000010000010000001
10000010000010000001
10000010000010000001
10000010000010000001
10000010000010000001
10000011111110000001
10000000000000000001
10000000000000000001
1000000000000N000001
10000000000000000001
10000000000000000001
10000000000000000001
10000000000000000001
10000000000000000001
11111111111111111111
