NO assets/textures/north.xpm
SO assets/textures/south.xpm
WE assets/textures/west.xpm
EA assets/textures/east.xpm

1111111111111
1000000000001
1000000000001
1000000000001
1000000000001
1000000000001
1000000000001
10000E0000001
1000000000001
1000000000001
1000000000001
1000000000001
1111111111111
