NO assets/textures/north.xpm
SO assets/textures/south.xpm
WE assets/textures/west.xpm
EA assets/textures/east.xpm

F 0,0,0
C 0,0,0
  1111111111111 
 100000000000001
10100000000000101
10010000000001001
10001000000010001
10000100000100001
10000010001000001
10000001010000001
10000000N00000001
10000000000000001
10000000000000001
10000000000000001
10000000000000001
10000000000000001
10000000000000001
10000000000000001
 111111111111111