NO assets/textures/north.xpm
SO assets/textures/south.xpm
WE assets/textures/west.xpm
EA assets/textures/east.xpm
F 220,100,0
C 225,30,0

 1 1 1 1 1 1 1 1 1
111111111111111111111
100000000000000000001
110000000000000000011
 10000000000000000001
 11000000000000000011
  10000000000000000001
  11000000000000000011
   10000000S00000000001
  11000000000000000011
  10000000000000000001
 11000000000000000011
 10000000000000000001
110000000000000000011
100000000000000000001
111111111111111111111
 1 1 1 1 1 1 1 1 1
