NO assets/textures/north.xpm
SO assets/textures/south.xpm
WE assets/textures/west.xpm
EA assets/textures/east.xpm
F 220,100,0
C 225,30,0

1111111111111111111111111111111111111111111111111111111111111111111111111111111111111111111111111111
1000000000000000000000000000000000000000000000000000000000000000000000000000000000000000000000000001
1011111111111111111111111111111111111111111111111111111111111111111111111111111111111111111111111101
1010000000000000000000000000000000000000000000000000000000000000000000000000000000000000000000000101
1010111111111111111111111111111111111111111111111111111111111111111111111111111111111111111111110101
1010100000000000000000000000000000000000000000000000000000000000000000000000000000000000000000010101
1010101111111111111111111111111111111111111111111111111111111111111111111111111111111111111111010101
1010101000000000000000000000000000000000000000000000000000000000000000000000000000000000000001010101
1010101011111111111111111111111111111111111111111111111111111111111111111111111111111111111101010101
1010101010000000000000000000000000000000000000000000000000000000000000000000000000000000000101010101
1010101010111111111111111111111111111111111111111111111111111111111111111111111111111111110101010101
1010101010100000000000000000000000000000000000000000000000000000000000000000000000000000010101010101
1010101010101111111111111111111111111111111111111111111111111111111111111111111111111111010101010101
1010101010101000000000000000000000000000000000000000000000000000000000000000000000000001010101010101
1010101010101011111111111111111111111111111111111111111111111111111111111111111111111101010101010101
1010101010101010000000000000000000000000000000000000000000000000000000000000000000000101010101010101
1010101010101010111111111111111111111111111111111111111111111111111111111111111111110101010101010101
1010101010101010100000000000000000000000000000000000000000000000000000000000000000010101010101010101
1010101010101010101111111111111111111111111111111111111111111111111111111111111111010101010101010101
1010101010101010101000000000000000000000000000000000000000000000000000000000000001010101010101010101
1010101010101010101011111111111111111111111111111111111111111111111111111111111101010101010101010101
1010101010101010101010000000000000000000000000000000000000000000000000000000000101010101010101010101
1010101010101010101010111111111111111111111111111111111111111111111111111111110101010101010101010101
1010101010101010101010100000000000000000000000000000000000000000000000000000010101010101010101010101
1010101010101010101010101111111111111111111111111111111111111111111111111111010101010101010101010101
10101010101010101010101010000000000000000000000000000000000E0000000000000001010101010101010101010101
1010101010101010101010101111111111111111111111111111111111111111111111111110101010101010101010101101
1010101010101010101010100000000000000000000000000000000000000000000000000010101010101010101010101101
1010101010101010101010111111111111111111111111111111111111111111111111111010101010101010101010101101
1010101010101010101010000000000000000000000000000000000000000000000000001010101010101010101010101101
1010101010101010101011111111111111111111111111111111111111111111111111101010101010101010101010101101
1010101010101010101000000000000000000000000000000000000000000000000000101010101010101010101010101101
1010101010101010101111111111111111111111111111111111111111111111111110101010101010101010101010101101
1010101010101010100000000000000000000000000000000000000000000000000010101010101010101010101010101101
1010101010101010111111111111111111111111111111111111111111111111111010101010101010101010101010101101
1010101010101010000000000000000000000000000000000000000000000000001010101010101010101010101010101101
1010101010101011111111111111111111111111111111111111111111111111101010101010101010101010101010101101
1010101010101000000000000000000000000000000000000000000000000000101010101010101010101010101010101101
1010101010101111111111111111111111111111111111111111111111111110101010101010101010101010101010101101
1010101010100000000000000000000000000000000000000000000000000010101010101010101010101010101010101101
1010101010111111111111111111111111111111111111111111111111111010101010101010101010101010101010101101
1010101010000000000000000000000000000000000000000000000000001010101010101010101010101010101010101101
1010101011111111111111111111111111111111111111111111111111101010101010101010101010101010101010101101
1010101000000000000000000000000000000000000000000000000000101010101010101010101010101010101010101101
1010101111111111111111111111111111111111111111111111111110101010101010101010101010101010101010101101
1010100000000000000000000000000000000000000000000000000010101010101010101010101010101010101010101101
1010111111111111111111111111111111111111111111111111111010101010101010101010101010101010101010101101
1010000000000000000000000000000000000000000000000000001010101010101010101010101010101010101010101101
1011111111111111111111111111111111111111111111111111101010101010101010101010101010101010101010101101
1000000000000000000000000000000000000000000000000000101010101010101010101010101010101010101010101101
1111111111111111111111111111111111111111111111111110101010101010101010101010101010101010101010101101
1000000000000000000000000000000000000000000000000010101010101010101010101010101010101010101010101101
1111111111111111111111111111111111111111111111111010101010101010101010101010101010101010101010101101
1000000000000000000000000000000000000000000000001010101010101010101010101010101010101010101010101101
1111111111111111111111111111111111111111111111101010101010101010101010101010101010101010101010101101
1000000000000000000000000000000000000000000000101010101010101010101010101010101010101010101010101101
1011111111111111111111111111111111111111111110101010101010101010101010101010101010101010101010101101
1000000000000000000000000000000000000000000010101010101010101010101010101010101010101010101010101101
1111111111111111111111111111111111111111111010101010101010101010101010101010101010101010101010101101
1000000000000000000000000000000000000000001010101010101010101010101010101010101010101010101010101101
1111111111111111111111111111111111111111101010101010101010101010101010101010101010101010101010101101
1000000000000000000000000000000000000000101010101010101010101010101010101010101010101010101010101101
1011111111111111111111111111111111111110101010101010101010101010101010101010101010101010101010101101
1000000000000000000000000000000000000010101010101010101010101010101010101010101010101010101010101101
1111111111111111111111111111111111111010101010101010101010101010101010101010101010101010101010101101
1000000000000000000000000000000000001010101010101010101010101010101010101010101010101010101010101101
1111111111111111111111111111111111101010101010101010101010101010101010101010101010101010101010101101
1000000000000000000000000000000000101010101010101010101010101010101010101010101010101010101010101101
1011111111111111111111111111111110101010101010101010101010101010101010101010101010101010101010101101
1000000000000000000000000000000010101010101010101010101010101010101010101010101010101010101010101101
1000000000000000000000000000000000000000000000000000000000000000000000000000000000000000000000000001
1111111111111111111111111111111111111111111111111111111111111111111111111111111111111111111111111111
