NO assets/textures/north.xpm
SO assets/textures/south.xpm
WE assets/textures/west.xpm
EA assets/textures/east.xpm

F 100,100,100
C 200,200,255

1111111111111111111111111111111
1000000000000000000000000000001
1000000000000000000000000000001
1000000111111111110000000000001
1000000100000000010000000000001
1000000100000000010000000000001
1000000100000W00010000000000001
1000000100000000010000000000001
1000000100000000010000000000001
1000000111111111110000000000001
1000000000000000000000000000001
1000000000000000000000000000001
1111111111111111111111111111111
