NO assets/textures/north.xpm
SO assets/textures/south.xpm
WE assets/textures/west.xpm
EA assets/textures/east.xpm

F 220,100,0
C 225,30,0
 11111 
1000001
1000001
100E001
1000001
1000001
 11111