NO assets/textures/north.xpm
SO assets/textures/south.xpm
WE assets/textures/west.xpm
EA assets/textures/east.xpm
F 220,100,0
C 225,30,0

111111111111111111111111111
100000000000000000000000001
101111111111111110000000001
100000000000000011000000001
100000000000000011100000001
101111111111111111110000001
100000000000000000011000001
100000000000000000011100001
101111111111111111111110001
100000000000000000000011001
100000000000000000000011101
101111111111111111111111111
100000000000000000000000001
10000000000000N00000000001
111111111111111111111111111
